Aabhas		আভাস
Aadarsh		আদর্শ
Aadavan		আদবন
Aadi		আদি
Aadit		আদিত
Aadiv		আদিব
Aahaan		আহান
Aahan		আহান
Aan		আন
Aanav		আনব
Aanay		আনয
Aarav		আরব
Aarin		আরিন
Aarit		আরিত
Aariv		আরীব
Aarnav		আর্নব
Aarnavi		আরনবী
Aarul		আরুল
Aaryan		আর্যন
Aaryav		আর্যব
Aashay		আশয
Aashray		আশ্রয
Aashresh	আশ্রেশ
Aasit		আসিত
Aayam		আযাম
Aayan		আযন
Aayush		আযুষ
Abhay		অভয
Abhayam		অভযম
Abheek		অভীক়
Abhey		অভেয
Abhi		অভী
Abhilesh		অভিলেশ
Abhinash		অভীনাশ
Abhinav		অভিনব
Abhishrey		অভিশ্রেয
Abhyan		অভযন
Achal		অচল
Achyut		অচ্যুত
Achyuta		অচ্যুতা
Adhish		অধীশ
Adhvik		অধ্বিক
Adhyan		অধ্যন
Adi		আদি
Adit		অদিত
Aditya		আদিত্য
Adiv		অদীব
Advik		অদ্বিক
Advit		অদ্বিত
Agam		অগম
Ahaan		অহান
Ahan		অহন
Aharshi		অহর্শী
Ahilan		আহিলন
Ainesh		আইনেশ
Ajayan		অজাযন
Ajeet		অজিত
Ajeeta		অজীতা
Ajesh		অজেশ
Ajitesh		অজ়িতেশ
Akansh		অকাংশ
Akash		আকাশ
Akil		অকীল
Akrish		অক্রীশ
Aksh		অক্ষ
Akshan		অক্ষণ
Akshansh		অক্ষাংশ
Akshant		অক্ষংত
Akshat		অক্ষত
Akshay		অক্ষয
Akshit		অক্ষিত
Akul		অকূল
Alin		অলীন
Aman		অমন
Amav		অমাব
Amay		অময
Amey		অমেয
Amish		অমীশ
Amitav		অমীতব
Amol		অমোল
Amolik		অমোলীক
Anany		অনন্য
Anav		অনব
Anchit		অংচিত
Aneek		অনিক
Anesh		অনেশ
Anik		অনিক
Aniket		অনিকেত
Anish		অনীশ
Anishk		অনিষ্ক
Anit		অনিত
Aniv		অনিব
Anjal		অংজল
Anjesh		অন্জেশ
Anjish		অন্জীশ
Ankesh		অংকেশ
Ankit		অংকিত
Anmay		অন্ময
Ansh		অংশ
Anshul		অংশুল
Anshum		অংশুম
Ansil		অন্সিল
Antim		অংতিম
Anu		অনু
Anuj		অনুজ
Anukrit		অনুকৃত
Anup		অনূপ
Anush		অনুষ
Anvay		অন্বয
Anvesh		অন্বেষ
Anvik		অন্বিক
Anvit		অন্বিত
Anwesh		অন্বেষ
Apurv		অপূর্ব
Arav		অরব
Aravan		অরাবন
Archin		অর্চিন
Archit		অর্চিত
Arghya		অর্ঘ্যা
Arhan		অরহান
Arihaan		অরিহান
Arihan		অরিহন
Arijit		অরিজীত
Arish		অরীশ
Arit		অরিত
Arjit		অর্জিত
Arjun		অর্জুন
Arnav		অর্নব
Arnesh		অর্নেশ
Arnish		অর্নীশ
Arnit		অর্নিত
Aroop		অরূপ
Arpan		অর্পণ
Arpil		অর্পিল
Arpit		অর্পিত
Arshvi		অর্শ্বী
Arthav		অর্থাব
Arthin		অর্থীন
Arthit		অর্থিত
Aruj		অরুজ
Arul		অরূল
Arumoy		অরুমোয
Aruni		অরুনী
Arush		অরূষ
Arushan		অরুষান
Arya		আর্যা
Aryan		আর্যন
Aryav		আর্যাব
Asas		অসাস
Asav		আসাও
Ashesh		অশেষ
Ashit		অষিত
Ashmit		অশ্মিত
Ashray		আশ্রয
Ashrit		আশ্রিত
Ashrut		অশ্রুত
Ashu		আশূ
Ashvik		অস্বীক
Asim		অসীম
Asit		অসিত
Astik		আস্তিক
Asul		অসুল
Ateet		অতীত
Atharv		অথর্ব
Atin		অতীন
Atish		অতিশ
Atit		অতীত
Ativ		অতীব
Atvi		অত্বী
Avadh		অবধ
Avan		অবন
Avi		অবি
Avik		অবীক
Avin		অবিন
Avir		অবির
Avirup		অবিরূপ
Avkash		অবকাশ
Avnesh		অব্নেশ
Ayaansh		অযাংশ
Ayan		অযান
Ayank		অযাংক
Ayansh		অযাংশ
Ayog		আযোগ
