Kahaan		কহান
Kairav		কৈরব
Kajish		কাজীশ
Kalap		কলাপ
Kalash		কলশ
Kalesh		কালেশ
Kalki		কল্কী
Kalkin		কল্কীন
Kalol		কলোল
Kalp		কল্প
Kalpa		কল্পা
Kalpit		কল্পিত
Kalva		কলবা
Kalyan		কল্যাণ
Kamesh		কামেশ
Kamik		কামীক
Kanal		কনল
Kanan		কানন
Kanav		কানব
Kandarp		কংদর্প
Kandarpa		কংদর্প
Kanha		কান্হা
Kanhu		কান্হুং
Kanil		কনিল
Kanish		কনিশ
Kanishk		কনিষ্ক
Kanishka		কনিষ্কা
Kannan		কন্নন
Kanv		কাংব
Kanvar		কংবর
Kapi		কাপী
Kapil		কপিল
Kapish		কপীশ
Karan		করন
Karhik		কার্হিক
Karm		কর্ম
Karma		কর্মা
Karn		কর্ণ
Karna		করনা
Kartik		কার্তিক
Karv		কর্ব
Kashish		কশিশ
Kasish		কশিশ
Kaustav		কৌস্তব
Kautik		কৌতিক
Kaval		কেবল
Kavan		কবন
Kavin		কবিন
Kavish		কবিশ
Kavisha		কবিষা
Kavit		কবিত
Kavy		কাব্য
Kavyan		কাব্যন
Kayansh		কাযংশ
Keethan		কীতন
Kesan		কেসন
Kesav		কেসব
Kesavan		কেসবান
Keshan		কেশন
Keshav		কেশব
Keshvin		কেশ্বীন
Ketav		কেতব
Ketu		কেতু
Ketul		কেতুল
Keva		কেবা
Keval		কেবল
Kevin		কেবিন
Kevit		কেবিত
Kewal		কেবল
Keyur		কেযূর
Khajit		খাজিত
Khsitij		খ্সীতীজ
Khusal		খুসাল
Khush		খুশ
Khushhal		খুশহাল
Khushil		খুশীল
Kian		কীঅন
Killan		কিল্লান
Kinal		কিনল
Kineesh		কিনীশ
Kinnar		কিন্নর
Kinshu		কিংশু
Kinshuk		কিংশুক
Kintesh		কিংতেশ
Kiran		কিরণ
Kirat		কীরত
Kirik		কিরীক
Kirin		কিরিন
Kirn		কির্ণ
Kirtesh		কীর্তেশ
Kishin		কিশন
Kishlay		কিশলয
Kishna		কিশ্না
Kislay		কিসলয
Kiyaan		কিযান
Kiyansh		কিযাংশ
Kiyash		কিযশ
Kohid		কোহিদ
Koshal		কৌশল
Koshin		কোশিন
Krinay		কৃণায
Kripa		কৃপা
Kripal		কৃপাল
Krisanu		ক্রীসনুং
Krish		ক্রিশ
Krishan		ক্রিশন
Krishang		ক্রিশংগ
Krishank		ক্রীশংক
Krishant		ক্রীশাংত
Krishanu		কৃশানু
Krishav		ক্রীশাব
Krishay		কৃশায
Krishil		ক্রিশীল
Krishiv		ক্রিশীব
Krishma		করিশ্মা
Krishna		কৃষ্ণা
Krishnam		কৃষ্ণম
Krishnav		কৃষ্ণাব
Krishneel		কৃশ্নিল
Kritik		কৃতিক
Kritin		ক্রিতীন
Krivi		ক্রিবী
Krrish		ক্রৃষ
Krunal		ক্রুণাল
Krushan		কৃশন
Kshemya		ক্ষেম্যা
Kshipra		ক্ষিপ্রা
Kshiraj		ক্ষীরাজ
Kshithij		ক্ষিতিজ
Kshitij		ক্ষিতিজ
Kshitish		ক্ষিতীশ
Kuhan		কুহান
Kuldeep		কুলদীপ
Kulik		কুলিক
Kulin		কুলীন
Kundir		কুংদীর
Kunj		কুংজ
Kunjal		কুংজল
Kunsh		কুংশ
Kush		কুশ
Kushaan		কুশান
Kushad		কুশাদ
Kushak		কুশক
Kushal		কুশল
Kushan		কুশন
Kushank		কুশংক
Kuval		কুংবল
Kuvam		কুবম
