Maahir		মাহির
Maalav		মালব
Maalin		মালীন
Maan		মান
Maanav		মানব
Madhav		মাধব
Madhava		মাধব
Madhavan		মাধবন
Madhup		মধুপ
Madhur		মধুর
Madin		মদীন
Magesh		মাংগেশ
Mahee		মাহী
Maheem		মহীম
Maheep		মহীপ
Mahendi		মহেংদী
Mahiman		মহিমন
Mahin		মহীন
Mahish		মহীষ
Mahit		মাহিত
Mahnav		মহনাব
Mainak		মৈনাক
Malesh		মলেশ
Malhar		মল্হার
Malhari		মল্হারী
Man		মন
Manalp		মনাল্প
Manan		মনন
Manank		মনাংক
Manant		মনাংত
Manas		মানস
Manav		মানব
Maneet		মনীত
Manesh		মনেশ
Manik		মানিক
Manim		মনীম
Manjul		মংজুল
Mansh		মানষ
Manuj		মনুজ
Manvik		মানবিক
Manvit		মন্বিত
Mardav		মার্দব
Marine		মরীন
Maulesh		মৌলেশ
Maulik		মৌলিক
Mayon		মযোন
Meet		মিত
Meetul		মিতুল
Mehan		মহান
Midhil		মীধীল
Mihit		মীহিত
Mihul		মীহুল
Mikesh		মিকেশ
Milap		মিলাপ
Milind		মিলিংদ
Milit		মিলিত
Mishay		মীশয
Mishrit		মিশ্রিত
Mit		মিত
Mital		মিতল
Mitang		মীতংগ
Mitansh		মিতাংশ
Mitanshu		মিতাংশু
Miten		মিতেন
Mitin		মিতিন
Mittal		মিত্তল
Mittali		মীত্তালী
Mitul		মিতুল
Mivaan		মিবান
Moh		মোহ
Mohak		মোহক
Mohal		মোহল
Mohil		মোহিল
Mohin		মোহীন
Mohit		মোহিত
Mohnish		মোহনীশ
Mohul		মোহুল
Moksh		মোক্ষ
Mokshal		মোক্ষাল
Mokshi		মোক্ষী
Mokshit		মোক্ষিত
Monank		মোনাংক
Monark		মোনার্ক
Monik		মোনীক
Mouli		মৌলী
Mriga		মৃগা
Mrigesh		মৃগেশ
Mrinal		মৃণাল
Mudil		মুদিল
Mudit		মুদিত
Muhil		মুহীল
