Nabhij		নাভিজ
Nabil		নবীল
Nachik		নচিক
Nachiket		নচিকেত
Nadeesh		নদীশ
Nadin		নাদীন
Nadir		নাদির
Nadish		নদিশ
Nahul		নাহুল
Nahush		নহুষ
Naimesh		নৈমেষ
Naimish		নৈমিষ
Nainesh		নৈনেশ
Nainish		নৈনীশ
Nairit		নৈঋত্য
Naishal		নৈশাল
Naitik		নৈতিক
Naksh		নক্শ
Naksha		নক্শা
Nakul		নকুল
Nal		নল
Naman		নমন
Namit		নমিত
Natesh		নতেশ
Navay		নবয
Navil		নাবিল
Neal		নীল
Neehal		নিহাল
Neehant		নীহংত
Neehar		নিহার
Neel		নীল
Neelabh		নীলাভ
Neer		নীর
Neesh		নিশ
Neeshik		নীষিক
Neeshlin		নিশলিন
Neev		নীব
Neil		নীল
Nelvin		নেল্বীন
Nemi		নেমী
Niam		নীঅম
Nibhish		নিভীষ
Nibhiv		নীভীব
Nideesh		নিদেষ
Nidesh		নিদেশ
Nidish		নীদীশ
Nihaar		নিহার
Nihal		নিহাল
Nihar		নিহার
Nihit		নিহিত
Nijay		নিজয
Nikash		নিকেশ
Nikesh		নিকেশ
Niket		নিকেত
Niketan		নিকেতন
Nikhar		নিখার
Nikhat		নিখত
Nikhil		নিখিল
Nikhilesh		নিখিলেশ
Nikhit		নীখিত
Nikil		নীকীল
Nikit		নিকিত
Nilabh		নীলাভ
Nill		নীল
Nimesh		নিমেশ
Nimish		নিমিষ
Nimit		নিমিত
Nimmit		নিম্মিত
Ninad		নিনাদ
Niraj		নীরজ
Niral		নিরল
Nirav		নীরব
Nirbhay		নির্ভয
Nirbhik		নির্ভীক
Nirmesh		নির্মেশ
Nirmohi		নির্মোহী
Nirup		নিরূপ
Nirupam		নিরুপম
Nirvan		নির্বাণ
Nirvash		নির্বশ
Nirved		নির্বেদ
Nisarg		নিসর্গ
Nischal		নিশ্চল
Nischay		নিশ্চয
Nischit		নিশ্চিত
Nish		নিষ্
Nishaan		নিশান
Nishal		নিশাল
Nisham		নিশাম
Nishan		নিশান
Nishanath		নিশানাথ
Nishant		নিশাংত
Nishar		নিশার
Nisharg		নীশার্গ
Nishat		নিশাত
Nishav		নিশব
Nishchay		নিশ্চয
Nishchit		নিশ্চিত
Nishesh		নিশেষ
Nishil		নিশীল
Nishit		নিশিত
Nishita		নিশিতা
Nishkarsh		নিষ্কর্ষ
Nishok		নিশোক
Nishv		নিশ্ব
Nishy		নিষ্য
Nissim		নিস্সীম
Nissin		নীস্সীন
Nit		নিত
Niteen		নীতিন
Niteesh		নীতীশ
Nitesh		নিতেশ
Nitul		নীতুল
Nityam		নিত্যং
Nityansh		নিত্যাংশ
Nityanta		নিত্যংতা
Niv		নীব
Nivaan		নীবান
Nivas		নিবাস
Nivash		নিবাস
Nived		নীবেদ
Nivedan		নিবেদন
Nivesh		নিবেশ
Nivin		নিবিন
Niya		নীযা
Niyam		নিযম
Niyan		নিযান
Nomit		নোমিত
Nrip		নৃপ
Nripa		নৃপা
Nripan		ন্রীপন
Nripesh		ন্রিপেশ
