Oha		ওহা
Ohas		ওহস
Oisin		ওঈসীন
Ojas		ওজস
Ojaswin		ওজস্বিন
Ojayit		ওজযিত
Ojis		ওজিস
Ojjaswin		ওজস্বিন
Omaansh		ওমাংশ
Omanand		ওমানংদ
Omarjeet		ওমরজীত
Omav		ওমাব
Omdutt		ওমদত্ত
Omesa		ওমেসা
Omesh		ওমেশ
Omeshwar		ওমেশ্বর
Omish		ওমীশ
Omja		ওম্জা
Omkar		ওমকার
Omkara		ওমকারা
Omkrish		ওমকৃশ
Omna		ওমনা
Ompati		ওমপতি
Omswaroop		ওমস্বরূপ
Onain		ওনৈন
Onir		ওনীর
Onis		ওনীস
Onish		ওনীশ
Onkar		ওংকার
Onnesha		ওন্নেশা
Oojam		ঊজম
Oorjit		ঊর্জিত
Oshee		ওশি
Oshin		ওশীন
Ovais		ওবৈস
Ovi		ওবী
Ovin		ওবীন
Ovishkar		ওবীশ্কার
Oviyan		ওবিযান
