Raag		রাগ
Raaghav		রাঘব
Raahul		রাহুল
Raazi		রাজী
Rachit		রচিত
Radhak		রাধাক
Radhav		রাধাব
Radhesh		রাধেশ
Radhey		রাধেয
Raghav		রাঘব
Rahal		রহল
Rahas		রহস
Rahi		রাহী
Raj		রাজ
Rajit		রাজিত
Rajiv		রাজীব
Rajus		রাজুস
Raktim		রক্তিম
Ranjiv		রংজীব
Ransh		রংশ
Ranvir		রনবীর
Rasesh		রসেশ
Rashesh		রশেষ
Rashil		রশীল
Rashmil		রশ্মীল
Ratnam		রতনম
Ratul		রতুল
Raul		রৌল
Raveen		রবীন
Ravin		রবীন
Ravish		রবীশ
Ravit		রবিত
Reet		রীত
Rehansh		রেহংশ
Rehit		রেহিত
Renil		রেনীল
Renit		রেনিত
Reshav		রেশাব
Reshvin		রেশ্বীন
Revan		রেবান
Revant		রেবংত
Reyaan		রেযান
Reyan		রেযান
Reyansh		রেযাংশ
Rhudhul		র্হুধুল
Rian		রিযন
Ridan		রীদন
Ridesh		রীদেশ
Rigesh		রীগেশ
Rigved		রীগ্বেদ
Rihaan		রিহান
Rijish		রীজীশ
Rijul		রিজূ
Rikhav		রিখাব
Rikhil		রিখীল
Rikin		রিকিন
Rinshi		রিণশী
Ripal		রীপল
Ripan		রিপন
Rish		রিষ
Rishab		ঋষব
Rishabh		ঋষভ
Rishant		রিষাংত
Rishap		রীশাপ
Rishat		রিশত
Rishav		রীশাব
Risheek		রীশিক
Rishen		রীশেন
Rishik		ঋষিক
Rishit		ঋষিত
Rishov		রীশোব
Rishta		রিশ্তা
Ritain		ঋতেন
Ritam		ঋতম
Ritil		রীতীল
Ritul		রীতুল
Ritvik		ঋত্বিক
Rivan		রিবান
Riyansh		রীযংশ
Robin		রোবীন
Rohaan		রোহান
Rohak		রোধক
Rohan		রোহন
Rohant		রোহংত
Rohi		রোহী
Rohil		রোহিল
Rohinish		রোহিনিশ
Rohit		রোহিত
Romik		রোমিক
Romil		রোমীল
Rubin		রূবীন
Ruchit		রুচিত
Rudraksh		রুদ্রাক্ষ
Rudram		রুদ্রম
Rudresh		রূদ্রেশ
Rudved		রুদ্বেদ
Rugved		ঋগ্বেদ
Ruhan		রূহান
Rujul		রূজূল
Rukm		রুক্ম
Runal		রুনল
Runik		রুনিক
Rushaal		রুশাল
Rushabh		ঋষভ
Rusham		রুষম
Rushang		রুশংগ
Rushank		রুশংক
Rushant		রুশাংত
Rushi		ঋষি
Rushik		ঋষিক
Rushil		ঋশীল
Rushit		ঋষিত
Rushmil		রুশ্মিল
Rut		ঋত
Rutansh		ঋতাংশ
Rutesh		ঋতেশ
Rutujit		ঋতুজীত
Rutvij		রুত্বিজ
Rutvik		ঋত্বিক
Ruzal		রুজল
