Vadin		বাদীন
Vadish		বাদিশ
Vahin		বহীং
Vaibhav		বৈভব
Vaidesh		বৈদেশ
Vaishnav		বৈষ্ণব
Vajraksh		বজ্রাক্ষ
Vajrin		বজ্রিন
Vakshal		বক্শাল
Vakul		বাকুল
Valak		বলাক
Valin		বালীন
Vallabh		বল্লভ
Valmik		বাল্মিক
Vamshi		বাম্শী
Vandan		বংদন
Vandit		বংদিত
Vanij		বনিজ
Vansh		বংশ
Vanshil		বংশীল
Vanshul		বংশুল
Vanshya		বৈশ্য
Vardham		বর্ধম
Vardhan		বর্ধন
Varij		বারিজ়
Varin		বরিন
Varish		বারীশ
Varnam		বরণম
Varnit		বর্ণিত
Varsan		বর্সন
Varshan		বর্ষান
Varsheet		বর্ষিত
Varshil		বর্ষিল
Varshit		বর্ষীত
Vartanu		বর্তানু
Vartik		বর্তিক
Varun		বরুণ
Varunesh		বরুনেশ
Varya		বার্যা
Vasant		বসংত
Vasav		বাসব
Vasava		বসাবা
Vasin		বসীন
Vastav		বাস্তব
Vastin		বস্তীন
Vasu		বাসূ
Vasuman		বাসুমন
Vasumat		বসুমত
Vasur		বসুর
Vasush		বসুশ
Vatsal		বত্সল
Vatsalya		বাত্সল্য
Vatsin		বত্সিন
Ved		বেদ
Veda		বেদা
Vedan		বেদন
Vedang		বেদাংগ
Vedant		বেদাংত
Vedanta		বেদাংত
Vedas		বেদাস
Vedesh		বেদেশ
Vedhas		বেধাস
Vedi		বেদী
Vedik		বেদিক
Vedish		বেদীষ
Veekshit		বিক্ষিত
Veenand		বিনংদ
Veer		বীর
Vel		বেল
Velan		বেলন
Vendan		বেংদন
Veni		বেনী
Vibhaas		বিভাস
Vibhas		বিভাস
Vibhat		বিভাত
Vibhav		বিভাব
Vibhnil		বিভ্নীল
Vibhor		বিভোর
Vibhu		বিভূ
Vibhum		বিভুম
Vibhut		বিভুত
Vibhuti		বিভূতি
Vibodh		বিবোধ
Vidhan		বিধান
Vidhant		বিধাংত
Vidhesh		বিধেশ
Vidhu		বিধু
Vidhul		বিধুল
Vidish		বিদিশ
Vidun		বিদুন
Vidyesh		বিদ্যেশ
Vidyut		বিদ্যুত
Vigash		বিগাশ
Vighnesh		বিঘ্নেশ
Vignesh		বিগনেশ
Vihaan		বিহান
Vihal		বিহল
Vihan		বিহান
Vihang		বিহংগ
Vihanga		বিহংগা
Vihar		বিহার
Viharsh		বিহর্ষ
Vihas		বিহাস
Vihing		বিহিংগ
Vijai		বিজয
Vijansh		বিজাংশ
Vijayen		বিজযেন
Vijeesh		বিজীশ
Vijesh		বিজেশ
Vijit		বিজীত
Vijith		বিজীত
Viju		বীজু
Vijul		বিজুল
Vikash		বিকাস
Viken		বিকেন
Vikern		বিকর্ণ
Vikesh		বিকেশ
Vikil		বিকীল
Vimlesh		বিমলেশ
Vimol		বিমোল
Vinay		বিনয
Vineel		বিনিল
Vineet		বিনীত
Vinek		বিনেক
Vinesh		বিনেশ
Vinil		বিনিল
Vinish		বিনীশ
Vinshal		বিন্শাল
Vipin		বিপিন
Viplav		বিপ্লব
Viplov		বিপ্লব
Vipra		বিপ্রা
Vipul		বিপুল
Viraaj		বিরাজ
Virag		বিরাগ
Viral		বিরল
Viransh		বিরংশ
Virat		বিরাট
Viren		বীরেন
Virochan		বিরোচন
Virom		বিরোম
Viroop		বিরূপ
Virta		বিরতা
Virudh		বিরুদ্ধ
Virun		বীরুন
Visarg		বীসর্গ
Vish		বিশ
Vishank		বিশংক
Vishant		বিশাংত
Vishatan		বিশাতন
Vishesh		বিশেষ
Visheta		বিশেতা
Vishram		বিশ্রাম
Vishrut		বিশ্রুত
Vishu		বিশু
Vishv		বিশ্ব
Vishva		বিশ্বা
Vishvag		বিশ্বাগ
Vishvam		বিশ্বম
Vishvas		বিশ্বাস
Vishvesh		বিশ্বেশ
Vishwak		বিশ্বক
Vishwam		বিশ্বম
Vishwas		বিশ্বাস
Vishwat		বিশ্বত
Visisht		বিশিষ্ট
Vismay		বিস্ময
Visruth		বিশ্রুত
Viswas		বিশ্বাস
Viswesh		বিশ্বেশ
Vitthal		বিঠ্ঠল
Vivaan		বিবান
Vivan		বিবান
Vivash		বিবশ
Vivek		বিবেক
Viven		বিবেন
Vivikshu		বিবীক্ষু
Viyaan		বীযান
Viyan		বিযন
Viyom		বিযোম
Vraj		ব্রজ
Vrij		ব্রীজ
Vriksh		ব্রিক্ষ
Vrisa		ব্রিসা
Vrisag		বৃসগ
Vrisan		বৃসন
Vrish		বৃষ
Vrisha		বৃষা
Vrishab		বৃষভ
Vrishabh		বৃষভ
Vrishank		বৃষাংক
Vrishin		বৃষিন
Vrit		ব্রিত
Vritant		বৃতান্ত
Vrusath		বৃসত
Vrushank		বৃষাংক
Vrushik		বৃষিক
Vrushket		বৃষকেত
Vyan		ব্যান
Vyasa		ব্যাসা
Vyom		ব্যোম
Vyoman		ব্যোমন
Vyomang		ব্যোমাংগ
Vyomesh		ব্যোমেশ
Vyshnav		বৈষ্ণব
