Nita		নীতা
Nitha		নীতা
Neela		নীলা
Nila		নীলা
Neepa		নীপা
Nipa		নিপা
Nishi		নিশি
Neesha		নিশা
Neha		নেহা
Nitu		নিতু
Neeru		নীরু
Neethu		নীতূ
Neetu		নীতু
Niju		নিজু
Naomi		নৌমী
Neeha		নীহা
Nira		নীরা
Nimmi		নিম্মী
Neera		নিরা
Nidi		নিদী
Nandini		নন্দিনী
Nandhinee	নন্দিনী
Namitha		নমিতা
Navanya		নবন্যা
Nidheepa	নিধিপা
Nirupa		নিরূপা
Nimitha		নিমিতা
Nidhipa		নিধিপা
Nipuna		নিপুণা
Navitha		নবীতা
Naveetha	নবীতা
Navita		নবিতা
Navitha		নবিতা
Nivetha		নিবেতা
Nupur		নুপুর
Noopur		নূপুর
Nitika		নিতিকা
Nikitha		নিকিতা
Nihitha		নিহিতা
Nishika		নিশিকা
Neeshika	নিশিকা
Nyshita		নিশিতা
Nivita		নীবিতা
Nitisha		নীতিশা
Nithisha	নীতিশা
Neethika	নীতিকা
Nayani		নয়নী
Nayana		নযনা
Nivriti		নিবৃতি
Nainika		নৈনিকা
Namisha		নমিষা
Naksha		নক্শা
Namita		নমীতা
Nadia		নাদিয়া
Nadiya		নাদিয়া
Natasha		নাতাশা
Neelima		নীলিমা
Nilima		নিলীমা
Nandita		নন্দিতা
Neisha		নেঈশা
Naomika		নোমিকা
Nirmala		নির্মলা
Navnita		নবনীতা
Nirjala		নির্জলা
Narmitha		নর্মিতা
Nairuthi		নৈঋতি
Nayonika		নয়নিকা
Noyonika		নয়নিকা
Nilakshi		নীলাক্ষী
Neelakshi		নীলাক্ষী
Nowshin			নওশীন
Nilambari		নীলাম্বরী
Neelambari		নীলাম্বরী
Niharica		নিহারিকা
Niharika		নিহারিকা
Neharika		নিহারিকা
Neeharika		নিহারিকা
Nirupama		নিরুপমা
Nivedita		নিবেদিতা
Nivedhita		নিবেদিতা
Niveditha		নিবেদিতা