Rai			রাঈ
Rut			ঋত
Ruth		ঋত
Rutu		ঋতু
Renu		রেণু
Rebha		রেভা
Rekha		রেখা
Riya		রিয়া
Roma		রমা
Ratri		রাত্রি
Radhya		রাধ্যা
Radha		রাধা
Rashi		রাশি
Rakhi		রাখী
Raakhi		রাখী
Rudra		রুদ্রা
Rooni		রুনী
Rudri		রুদ্রী
Rubi		রূবী
Ruhi		রূহী
Rupa		রূপা
Ruma		রূমা
Rumpa		রূম্পা
Ruha		রূহা
Raahi		রাহী
Rohi		রোহী
Rosa		রোসা
Ridhi		রিধী
Riddhi		রিদ্ধি
Risha		রিষা
Reeta		রিতা
Rita		রিতা
Reena		রিনা
Rinki		রিংকী
Rency		রেন্সী
Rithu		রীতু
Rimi		রীমী
Rima		রীমা
Reema		রীমা
Ripa		রীপা
Reeja		রীজা
Risva		রিস্বা
Rakti		রক্তি
Radhika		রাধিকা
Raadhika	রাধিকা
Ridhika		রিধিকা
Ragini		রাগিনী
Romila		রোমিলা
Ridhima		রিধিমা
Rikita		রিকিতা
Richika		রিচিকা
Ridika		রিদিকা
Rihana		রিহানা
Reshma		রেশ্মা
Reshmi		রেশ্মী
Resmi		রেশমী
Rehana		রেহানা
Rudrani		রুদ্রাণী
Rupika		রুপিকা
Rupali		রুপালী
Ruhani		রুহানী
Ruchita		রুচিতা
Ramila		রমিলা
Ramita		রমিতা
Ramitha		রমিতা
Rajani		রজনী
Rajitha		রজিতা
Rachna		রচনা
Rachita		রচিতা
Ravina		রবিনা
Rithisha	রীতিশা
Renuka		রেণুকা
Ruhika		রূহিকা
Rishita		ঋষিতা
Rishika		ঋষিকা
Rushika		ঋষিকা
Ritika		ঋতিকা
Rithika		ঋতিকা
Rutika		ঋতিকা
Rushali		রুষালী
Rashmita	রশ্মিতা
Rashmitha	রশ্মিতা
Ruparna		রুপর্ণা
Rupasi		রূপসী
Rasana		রসনা
Rajkumari		রাজকুমারী
Rajakanya		রাজকন্যা
Rishipriya		ঋষিপ্রিয়া
Rikshiti		রীক্ষিতি
Rituparna		ঋতুপর্ণা
RudraPriya		রুদ্রপ্রিয়া
Ratnalekha		রত্নালেখা
Rouprita		রূপ্রীতা