Sara		সারা
Saara		সারা
Saya		সায়া
Saanvi		সান্বী
Sachi		সাচী
Saachi		সাচী
Smita		স্মিতা
Shikha		শিখা
Sriya		শ্রিয়া
Shriya		শ্রিয়া
Shilpi		শিল্পী
Shipra		শিপ্রা
Shishta		শিষ্টা
Seema		সীমা
Sumi		সুমি
Shrena		শ্রেনা
Sreeya		শ্রেয়া
Setu		সেতু
Sneha		স্নেহা
Saini		সৈনী
Shaili		শৈলী
Shuddhi		শুদ্ধি
Sobha		শোভা
Shobha		শোভা
Suchi		সূচী
Sukthi		সূক্তি
Shruti		শ্রুতি
Shrutee		শ্রুতি
Smrita		স্মৃতা
Smiti		স্মীতি
Smriti		স্মৃতি
Smrithi		স্মৃতি
Sristi 		সৃষ্টি
Swarna		স্বর্ণা
Snithi		স্নিতি
Swapna		স্বপ্না
Snigdha		স্নিগ্ধা
Sparsha		স্পর্শ
Sparsha		স্পর্শা
Spruha		স্পৃহা
Spoorti		স্পূর্তি
Spoorthi	স্পূর্তি
Sangya		সংজ্ঞা
Shyama		শ্যামা
Samapti		সমাপ্তি
Samrita		সমৃতা
Sabita		সবিতা
Savita		সবিতা
Saneha		সনেহা
Sarupa		সরূপা
Samisa		সমীসা
Sangita		সংগীতা
Saahana		সাহনা
Sarika		সারিকা
Sania		সানিয়া
Sadhna		সাধনা
Sharika		শারিকা
Salini		শালিনী
Shayna		শায়না
Shirin		শিরীন
Suprita		সুপ্রীতা
Supreeta	সুপ্রীতা
Supreetha	সুপ্রীতা
Suvarna		সুবর্না
Suparna		সুপর্ণা
Sumati		সুমতি
Sulekha		সুলেখা
Sumitra		সুমিত্রা
Suneeta		সুনিতা
Sunita		সুনীতা
Sunitha		সুনীতা
Sumita		সুমীতা
Sumitha		সুমীতা
Surbhi		সুরভী
Surabhi		সুরভী
Sudipti		সুদিপ্তী
Sudeepa		সুদীপা
Swarnika	স্বর্নিকা
Sonam		সোনম
Sohni		সোহনী
Sohana		সোহনা
Sonali		সোনালী
Sonia		সোনিয়া
Sonika		সোনিকা
Sonakshi	সোনাক্ষী
Sowmika		সৌমিকা
Soundarya	সৌন্দর্য
Sanhata		সংহিতা
Sangeetha	সংগীতা
Snehalata	স্নেহলতা
Shamali		শ্যামলী
Shyamali	শ্যামলী
Srinika		শ্রীনিকা
Shrilekha	শ্রীলেখা
Swatika		স্বাতিকা
Swarnalata		স্বর্ণলতা
Shatarupa		শতরূপা
Sudarshana		সুদর্শনা
Satyapriya		সত্যপ্রিয়া
Seemantini		সীমন্তিনী


১৩৬০