Daanish		দানীশ
Daarshik		দার্শিক
Dahak		দাহক
Daivansh		দৈবংশ
Daivat		দৈবত
Daksh		দক্ষ
Dakshak		দক্ষক
Dakshesh		দক্ষেষ
Dakshi		দক্ষী
Dakshin		দক্ষিণ
Dakshith		দক্ষিত
Danish		দানীশ
Danuj		দনুজ
Darpad		দর্পদ
Darpak		দর্পক
Darpan		দর্পণ
Darpit		দর্পিত
Darsh		দর্শ
Darshak		দর্শক
Darshal		দর্শল
Darsheel		দর্শীল
Darshik		দর্শিক
Darshil		দর্শীল
Darshish		দার্শিশ
Darshit		দর্শিত
Dax		দক্ষ
Daxesh		দক্ষেশ
Deepal		দীপল
Deepan		দীপন
Deepen		দিপেন
Deepesh		দীপেশ
Deepit		দীপিত
Deepjay		দীপজয
Deshik		দেশিক
Dev		দেব
Devaansh		দেবাংশ
Devak		দেবক
Deval		দেবল
Devamsh		দেবাংশ
Devan		দেবন
Devang		দেবাংগ
Devank		দেবাংক
Devansh		দেবাংশ
Devansha		দেবান্শা
Devarsh		দেবর্ষ
Devarshee		দেবর্ষি
Devarshi		দেবর্ষি
Deven		দেবেন
Devesh		দেবেশ
Devyam		দেব্যম
Dewesh		দেবেশ
Deyaan		দযান
Dhairya		ধৈর্য
Dhaneesh		ধনেশ
Dhanush		ধনুষ
Dharish		ধারিশ
Dharmi		ধর্মী
Dharmik		ধার্মিক
Dharmil		ধার্মিল
Dharvin		ধর্বীন
Dhavnit		ধ্বনিত
Dheer		ধীর
Dheeran		ধীরেন
Dhikshit		ধীক্ষিত
Dhilan		ধিলন
Dhilen		ধীলেণ
Dhrish		দৃষ্য
Dhriti		ধৃতি
Dhritil		ধৃতিল
Dhrumil		ধ্রুমীল
Dhrushil		ধ্রুশীল
Dhrut		ধৃত
Dhrutav		ধৃতব
Dhruv		ধ্রুব
Dhruvansh		ধ্রুবংশ
Dhruvav		ধ্রুবাব
Dhruven		ধ্রুবেন
Dhruvesh		ধ্রুবেশ
Dhruvin		ধ্রুবিন
Dhruvish		ধ্রুবীশ
Dhruvit		ধ্রুবিত
Dhuvin		ধুবীন
Dhvanil		ধ্বনিল
Dhvansh		ধ্বংশ
Dhvanya		ধ্বন্যা
Dhven		ধ্বেন
Dhwanil		ধ্বনিল
Dhwanit		ধ্বনিত
Dhwnit		ধ্বনিত
Dhyan		ধ্যান
Dhyana		ধ্যানা
Dhyanesh		ধ্যানেশ
Dhyey		ধ্যেয
Dia		দিযা
Diasha		দিআশা
Digant		দিগংত
Diganth		দিগংত
Dijesh		দিজেশ
Dijul		দীজুল
Dikshit		দীক্ষিত
Dikshith		দীক্ষিত
Dinkar		দিনকর
Dinpal		দিনপাল
Dirash		দীরাশ
Dishaan		দিশান
Dishank		দিশাংক
Dishant		দিশাংত
Dishanth		দিশাংত
Dishen		দীশেন
Divam		দিবম
Divansh		দিবাংশ
Divaym		দিবায্ম
Divesh		দিবেশ
Divij		দীবীজ
Divit		দিবিত
Diviyansh		দীবিযাংশ
Divnesh		দিবনেশ
Divyam		দিব্যম
Divyang		দিব্যাংগ
Divyank		দীব্যাংক
Divyansh		দিব্যাংশ
Divyant		দিব্যাংত
Divyesh		দিব্যেশ
Diyan		দিযান
Dreshal		দরেশাল
Drish		দ্রীশ
Drishit		দ্রীষিত
Druv		ধ্রুব
Druva		ধ্রুবা
Druvam		ধ্রুবং
Druvil		দৃবীল
Durvank		দুর্বাংক
Durvesh		দুর্বেশ
Durvish		দুর্বিশ
Dushyant		দুষ্যংত
Dwij		দ্বিজ
Dwijesh		দ্বিজেশ
