Gagnesh		গগ্নেশ
Gahan		গহন
Gaish		গৈশ
Gajrup		গজরূপ
Galav		গলব
Gaman		গমন
Gana		গণ
Ganak		গনক
Ganesan		গণেসন
Gangesh		গংগেশ
Ganjan		গংজন
Gaousik		গৌশিক
Garg		গর্গ
Gargee		গার্গী
Garisht		গরিষ্ট
Garv		গর্ব
Garveet		গর্বিত
Garvik		গার্বিক
Garvin		গার্বিন
Garvish		গার্বিশ
Garvit		গর্বিত
Gatik		গতিক
Gauransh		গৌরাংশ
Gaurav		গৌরব
Gaureesh		গৌরীশ
Gauresh		গৌরীশ
Gautham		গৌতম
Gavy		গব্য
Gayan		গাযন
Geet		গীত
Geetesh		গীতেশ
Gia		গিযা
Giri		গিরী
Girik		গিরিক
Girish		গিরীশ
Girivar		গিরিবর
Girjesh		গির্জেশ
Girvan		গিরবন
Girven		গিরবন
Gishi		গীশী
Gitesh		গীতেশ
Gitsh		গীতশ
Gopal		গোপাল
Gopan		গোপন
Gopesh		গোপেশ
Gorakh		গোরখ়
Goraksh		গোরক্ষ
Goral		গোরল
Govind		গোবিংদ
Govinda		গোবিংদা
Grahil		গ্রাহীল
Grahish		গ্রাহিশ
Grahit		গ্রহিত
Grihith		গৃহিত
Grishm		গ্রীষ্ম
Gritik		গ্রীতিক
Guhan		গুহান
Gulal		গুলাল
Gunav		গুনাব
Gunjan		গুংজন
Gupil		গুপিল
Gurmukh		গুরমুখ
Gurnam		গুরনাম
Guru		গুরু
Gyan		জ্ঞান
Gyanav		জ্ঞানব
