Haan		হান
Haard		হার্দ
Haarith		হারিত
Hameer		হমীর
Hamir		হমীর
Hamrish		হমরিষ
Hani		হানী
Hanish		হনীশ
Hansal		হংসল
Hanshal		হংশল
Hanshit		হন্ষিত
Hansik		হংসিক
Hansin		হংসিন
Hanvesh		হন্বেশ
Happy		হেপ্পী
Hara		হরা
Haran		হরণ
Hard		হার্ড
Hardhik		হার্দিক
Hardik		হার্দিক
Haresh		হরেশ
Haridra		হরিদ্র
Harikesh		হরিকেশ
Harin		হরিন
Harit		হারিত
Harjeet		হরজীত
Harjit		হরজীত
Harmesh		হরমেশ
Harnish		হরনীশ
Harprit		হরপ্রীত
Harsal		হর্সল
Harsh		হর্ষ
Harshal		হর্ষল
Harshat		হর্ষত
Harshil		হর্ষিল
Harshim		হাশিম
Harshnil		হর্ষনীল
Harshu		হরষু
Harshul		হর্ষুল
Harsit		হর্ষিত
Hashan		হশন
Hasith		হসিত
Havish		হবিষ
Heemal		হিমাল
Heer		হীর
Heeram		হীরাম
Heeran		হিরণ
Heet		হিত
Hem		হেম
Hemadri		হেমাদ্রী
Hemakesh		হেমাকেশ
Hemal		হেমল
Hemang		হেমাংগ
Hemank		হেমাংক
Hemanshu		হেমাংশু
Hemant		হেমংত
Hemdev		হেমদেব
Hemil		হেমিল
Hemin		হেমীন
Hemish		হেমিশ
Hemkesh		হেমকেশ
Hemu		হেমু
Henil		হেনীল
Henith		হেনীত
Herin		হেরীন
Herish		হেরিশ
Het		হেত
Hetaksh		হেতাক্ষ
Hetal		হেতল
Hetansh		হেতাংশ
Hetarth		হেতার্থ
Hetav		হেতব
Hetshree		হেতশ্রী
Hetvik		হেত্বিক
Himanish		হিমানিশ
Himank		হিমাংক
Himansh		হিমাংশ
Himesh		হিমেশ
Himi		হিমী
Himnish		হিম্নীশ
Hinesh		হিনেশ
Hiranyak		হিরংযক
Hirav		হিরব
Hiren		হিরেন
Hiresh		হিরেশ
Hishal		হিশাল
Hitaish		হিতৈষ
Hital		হিতল
Hitansh		হিতাংশ
Hitanshu		হিতাংশু
Hitarth		হিতার্থ
Hiten		হিতেন
Hitesh		হিতেশ
Homesh		হোমেশ
Hridaan		হ্রীদান
Hridan		হ্রীদন
Hriday		হৃদয
Hridesh		হ্রীদেশ
Hridik		হৃদিক
Hridith		হৃদিতঃ
Hrihaan		হরিহান
Hrihan		হরিহন
Hrikin		হরিকীং
Hriman		হরিমন
Hrisha		হরীশ
Hrishan		হরিশন
Hrishant		হরিশান্ত
Hrishi		হৃষী
Hrishikesh		হৃষিকেশ
Hrithik		হৃতিক
Hrithvik		হ্রীত্বিক
Hritik		হ্রিতিক
Hritish		হৃতিশ
Hrivaan		হ্রীবান
Hriyan		হরিযাঁ
Hriyansh		হ্রীযাংশ
Hrudhai		হৃদয
Hrudya		হৃদয
Hrutesh		হৃতেশ
Hruthik		হ্রুতিক
Hryday		হ্রদয
