Ibhan		ইভান
Idhant		ইধাংত
Iham		ঈহম
Ihit		ইহীত
Ijay		ইজয
Ikansh		একাংশ
Ikrut		ইকৃত
Iksha		ইক্ষা
Ikshan		ইক্ষণ
Ilesh		ইলেশ
Ilisa		এলিসা
Indivar		ইংদিবর
Indraneel		ইংদ্রনীল
Indrarjun		ইন্দ্রার্জুন
Indrasen		ইন্দ্রসেন
Indresh		ইন্দ্রেশ
Induj		ইন্দুজ
Indus		ঈন্দুস
Indushree		ইন্দুশ্রী
Inesh		ইনেশ
Inkit		ইংকিত
Ipil		ইপিল
Ipsit		ইপ্সিত
Iraj		ইরাজ
Irana		ইরনা
Iravan		ইরাবন
Iravat		ইরাবত
Iresh		ইরেশ
Iri		ইরী
Irya		ইর্যা
Ish		ইশ
Ishan		ঈশান
Ishank		ইশাংক
Ishayu		ইশাযু
Ishit		ইষিত
Ishmit		ইশ্মীত
Ishna		ঈশনা
Ishu		ইশূ
Iti		ইতি
Ivaan		ইবান
