Jagan		জগন
Jagesh		জাগেশ
Jagrav		জাগরাংব
Jagravi		জাগ্রবী
Jahnav		জাহ্নব
Jai		জয
Jaiden		জৈদেন
Jaidev		জযদেব
Jaikrish		জৈক্রীশ
Jailesh		জৈলেশ
Jaimesh		জৈমিষ
Jaimil		জৈমিল
Jaimin		জৈমীন
Jaimini		জৈমিনী
Jaimol		জৈমল
Jain		জৈন
Jainam		জৈনম
Jainand		জৈনংদ
Jaineel		জৈনীল
Jainesh		জৈনেশ
Jainil		জৈনিল
Jainish		জৈনীশ
Jaipal		জযপাল
Jaisal		জৈসল
Jaisan		জৈসন
Jaisheel		জযশীল
Jaishna		জৈশন
Jaival		জৈবল
Jaivant		জযবংত
Jaivik		জৈবিক
Jaksh		জক্ষ
Jal		জল
Jalesh		জলেশ
Jalp		জলপ
Jalpan		জলপান
Jameel		জমীল
Janav		জনাব
Janeesh		জনীশ
Janesh		জনেশ
Janis		জৈনিস
Janith		জনিত
Jankesh		জনকেশ
Janmesh		জন্মেশ
Janmeya		জনমেযা
Janu		জানু
Janya		জান্যা
Jap		জপ
Japan		জপন
Japesh		জপেশ
Japtesh		জপ্তেশ
Jarnav		জর্নাব
Jas		জস
Jasal		জসল
Jasamit		জসমিত
Jash		জশ
Jaskirit		জসকীরত
Jasmer		জস্মের
Jastin		জস্টীন
Jasveer		জসবীর
Jasvir		জসবীর
Jatak		জাতক
Jatan		জতন
Jatasya		জতস্যা
Jatayu		জটাযু
Jathin		জতিন
Jatin		জতিন
Jatya		জত্যা
Javesh		জবেশ
Javin		জাবিন
Jay		জয
Jayan		জযন
Jayay		জযায
Jayin		জযিন
Jaymen		জযমেন
Jaynil		জযনীল
Jaypal		জযপাল
Jayraj		জযরাজ
Jayram		জযরাম
Jayveer		জযবীর
Jaywant		জযবংত
Jazim		জজিম
Jebin		জেবীন
Jeet		জীত
Jeevesh		জীবেশ
Jenil		জেনীল
Jenish		জেনীশ
Jeram		জেরাম
Jesh		জেশ
Jeshan		জেশন
Jeval		জেবল
Jevan		জেবান
Jhoshil		ঝোশীল
Jigar		জীগর
Jigen		জিগন
Jihan		জিহান
Jijesh		জিজেশ
Jilesh		জিলেশ
Jimesh		জীমেশ
Jimit		জীমিত
Jina		জীনা
Jinal		জিনল
Jinansh		জিনাংশ
Jinay		জীনয
Jinesh		জীনেশ
Jiral		জীরল
Jishanth		জীশাংত
Jishnu		জিষ্ণু
Jishu		জীশুং
Jitain		জিতেন
Jiten		জীতেন
Jitesh		জীতেশ
Jithesh		জীতেশ
Jithin		জীতীন
Jitin		জীতীন
Jivaj		জিবজ
Jival		জীবল
Jivan		জীবন
Jivesh		জীবেশ
Jivin		জীবিন
Jivitesh		জীবিতেশ
Jivraj		জীবরাজ
Jivram		জীবরাম
Jiyaan		জিযান
Jiyan		জিযান
Jubin		জুবীন
Jyran		জযরণ
