Labh		লাভ
Lagan		লগান
Laghun		লঘুন
Lahar		লহর
Lakhan		লখন
Laksh		লক্ষ
Lakshan		লক্ষণ
Lakshanya		লক্ষন্য
Lakshay		লক্ষ্য
Lakshin		লক্ষিণ
Lakshit		লক্ষিত
Lakshith		লক্ষিত
Lakshya		লক্ষ্য
Laksmin		লক্ষ্মীন
Lalam		ললাম
Lalip		লালীপ
Lalit		ললিত
Langith		লংগীত
Laran		লারন
Latesh		লতেশ
Latish		লাতিষ
Laven		লাবেন
Lavesh		লাবেশ
Lavin		লাবীন
Lavish		লাবীশ
Lavit		লবিত
Lavith		লাবীত
Lavnya		লাবণ্য
Layak		লাযক
Layam		লযম
Lehan		লেহন
Lekh		লেখ
Lekhan		লেখন
Lekhit		লেখিত
Lekith		লেখিত
Lemar		লেমার
Lenin		লেনিন
Libeesh		লীবিশ
Lidin		লিদিন
Lijesh		লীজেশ
Likesh		লীকেশ
Likhil		লিখিল
Likhit		লিখিত
Likilesh		লিখিলেশ
Likith		লিখিত
Linay		লীনয
Linu		লীনুং
Lishan		লিশন
Loakhan		লোখন
Lochan		লোচন
Logesh		লোগেশ
Logithan		লোগিতাং
Lohit		লোহিত
Lohith		লোহিত
Lokesh		লোকেশ
Lokit		লোকিত
Lomesh		লোমেশ
Lopesh		লোপেশ
Lovepal		লবপাল
Lovesh		ল
Lovey		লোবী
Lovish		লবিশ
Luhit		লুহিত
Lukesh		লুকেশ
Lukesha		লুকেশা
Lupesh		লুপেশ
Luv		লব
Luvya		লুব্যা
