Padam		পদম
Padm		পদ্ম
Padman		পদমন
Padmesh		পদমেশ
Pahal		পহল
Palak		পলক
Palash		পলাশ
Palin		পালিন
Pallav		পল্লব
Palvit		পল্বিত
Panav		পনব
Pankil		পংকিল
Pankit		পংকিত
Panshul		পাংশুল
Param		পরম
Parav		পরব
Parichay		পরিচয
Parin		প৅রিন
Parmesh		পরমেশ
Parnad		পর্নাদ
Parnal		পর্নল
Parshv		পার্শ্ব
Parsva		পরস্বা
Parth		পার্থ
Parthav		পার্থব
Parthey		পার্থে
Parthik		পার্থিক
Parthiv		পার্থিব
Partho		পার্থো
Partish		প্রতিষ
Parv		পর্ব
Parva		পরবা
Pathik		পথিক
Pathin		পথিন
Paurav		পৌরব
Pavak		পাবক
Pavaki		পাবকী
Pavi		পবি
Pavin		পবীন
Pavish		পবীশ
Pavit		পবীত
Pavitra		পবিত্র
Pavleen		পবলীন
Pavni		পবনী
Phalak		ফলক
Phalgun		ফ়াল্গুন
Pinak		পীনাক
Pinaki		পিনাকী
Pinakin		পিনাকিন
Pinank		পিনাংক
Pinkay		পিংকয
Pinkesh		পীন্কেশ
Pival		পিবল
Piyush		পীযূষ
Poorv		পূর্ব
Prahan		প্রহন
Prahar		প্রহার
Praharsh		প্রহর্ষ
Prahasit		প্রহসিত
Prajeet		প্রজীত
Prajesh		প্রজেশ
Prajin		প্রজিন
Prajit		প্রজীত
Prajjwal		প্রজ্জ্বল
Prajnay		প্রজ্নায
Prajul		প্রজুল
Prajval		প্রজ্বল
Prajwat		প্রজ্বাত
Prajyot		প্রজ্যোত
Prakalp		প্রকল্প
Praket		প্রকট
Prakhil		প্রখীল
Prakrit		প্রাকৃত
Prakriti		প্রক্রিতি
Prakrut		প্রাকৃত
Prakul		প্রকুল
Prakunj		প্রকুংজ
Pralay		প্রলয
Pramit		প্রমিত
Pranaam		প্রণাম
Pranav		প্রণব
Pranay		প্রণয
Praneel		প্রনীল
Praneet		প্রণিত
Pranesh		প্রনেশ
Pranet		প্রনেত
Pranit		প্রণিত
Pranjal		প্রাংজল
Pranjul		প্রাংজুল
Pransu		প্রাংশু
Prarambh		প্রারংভ
Praroop		প্রারূপ
Prarthan		প্রার্থন
Prasham		প্রষম
Prateet		প্রতীত
Pratham		প্রথম
Pratim		প্রতীম
Pratish		প্রতিশ
Pratiti		প্রতীতি
Pratul		প্রতুল
Praval		প্রবল
Pravar		প্রবর
Pravir		প্রবীর
Pravit		প্রবিত
Prayank		প্রযাংক
Prayush		প্রযুশ
Preetam		প্রীতম
Preetesh		প্রীতেশ
Prem		প্রেম
Prerit		প্রেরিত
Princy		প্রীন্সী
Prineet		প্রিনীত
Prish		প্রীশ
Prit		প্রীত
Pritam		প্রীতম
Pritesh		প্রীতেশ
Prithiv		প্রীতিব
Priyan		প্রিযান
Priyank		প্রিযংক
Priyansh		প্রিযাংশ
Priyanshu		প্রিযাংশু
Priyesh		প্রিযেশ
Pujit		পূজীত
Punit		পুনীত
Puran		পুরান
Purav		পূর্ব
Purvaj		পূর্বজ
Purvang		পূর্বাংগ
Purvesh		পূর্বেশ
Pushkar		পুষ্কর
Pushkin		পুশ্কিন
Pushp		পুষ্প
