Saahil		সাহিল
Saaksh		সাক্ষ
Sachet		সচেত
Sachin		সচিন
Sachish		সচিশ
Sachit		সচিত
Sachitan	সচিতাং
Sachiv		সচিব
Saharsh		সহর্ষ
Sahas		সাহস
Sahay		সহায
Sahdev		সহদেব
Sai		সাঈ
Saihish		সেহিশ
Sailik		শৈলীক
Sainit		সৈনীত
Saivi		সৈবী
Saket		সাকেত
Saksham		সক্ষম
Sakshan		সক্ষণ
Samanvey	সমন্বয
Sambhav		সংভব
Sameep		সমীপ
Samen		সমেন
Samesh		সমেশ
Samiksh		সমিক্ষ
Samrat		সম্রাট
Samridh		সম্রীধ
Sanat		সনত
Sanatan		সনাতন
Sanav		সনব
Sanay		সনয
Sanchay		সংচয
Sanchi		সাংচী
Sanchit		সংচিত
Sandeepan		সংদীপন
Sandesh		সংদেশ
Sandip		সংদীপ
Saneesh		সনিষ
Sanehi		সনেহী
Sani		সানী
Sanidh		সনিধ
Sanil		সনীল
Sanish		সনীশ
Sanjan		সংজন
Sanjeet		সংজীত
Sanjeev		সংজীব
Sanjeevan		সংজীবন
Sanjeevi		সংজীবী
Sanjib		সংজীব
Sanjit		সংজীত
Sanjiv		সংজীব
Sanju		সংজু
Sanket		সংকেত
Sanketh		সংকেত
Sankul		সংকুল
Sanmit		সংমিত
Sanoop		সনূপ
Saral		সরল
Saransh		সারাংশ
Sarav		সারব
Saresh		সরেশ
Sargam		সরগম
Sarin		সারিন
Sarish		সারিশ
Saru		সারুং
Sarup		সরূপ
Sarva		সর্ব
Sarvam		সর্বম
Sarvesh		সর্বেশ
Sarwa		সরবা
Sashank		সশাংক
Satesh		সতেশ
Satin		সতীন
Satvik		সাত্বিক
Satwik		সাত্বিক
Satyam		সত্যম
Satyen		সত্যেন
Saumil		সৌমিল
Saumit		সৌমিত
Saumitr		সৌমিত্র
Saumy		সৌম্য
Saurin		সৌরিন
Seenu		সীনুং
Selvam		সেল্বাম
Setu		সেতু
Shaar		শার
Shabd		শব্দ
Shabin		শবীন
Shahan		শহন
Shahant		শাহংত
Shail		শৈল
Shailen		শৈলেন
Shaiv		শৈব
Shaji		শাজী
Shalik		শালিক
Shalin		শালীন
Shameek		শমীক
Shami		শমী
Shamik		শমিক
Shamir		শমীর
Shamit		শমিত
Shantam		শন্তম
Shantan		শাংতন
Shantanav		শংতানব
Shantanu		শংতানু
Shanu		শানুং
Sharat		শরত
Sharav		শারব
Sharvas		শর্বাস
Sharvesh		শর্বেশ
Sharvil		শর্বিল
Sharvin		শর্বীন
Shatayu		শতাযু
Shauchin		শৌচিন
Shaurav		শৌরব
Shay		শয
Sheehan		শ্রীহন
Sheil		শৈল
Shejal		শেজল
Sheya		শিযা
Shibhya		শিভ্য
Shibin		শীবীন
Shibu		শিবু
Shihir		শীহির
Shilang		শিলাংগ
Shilish		শিলিশ
Shimul		শীমুল
Shiney		শীনেয
Shinoy		শিনোয
Shiny		শীনী
Shirin		শিরীন
Shirish		শিরশ
Shivaksh		শীবাক্ষ
Shivam		শিবম্
Shivank		শিবাংক
Shivansh		শিবাংশ
Shivanshu		শিবাংশু
Shivel		শিবেল
Shiven		শিবেন
Shivesh		শিবেশ
Shivin		শিবিন
Shivmati		শিবমতি
Shkear		শকর
Shonil		শোনীল
Shoor		শূর
Shreel		শ্রীল
Shreesh		শ্রীশ
Shrenik		শ্রেনিক
Shresht		শ্রেষ্ট
Shrey		শ্রেয
Shreyan		শ্রেযন
Shreyank		শ্রেযাংক
Shreyash		শ্রেযশ
Shri		শ্রী
Shrijay		শ্রীজয
Shrilesh		শ্রীলেশ
Shrimat		শ্রীমত
Shriyam		শ্রিযম
Shriyan		শ্রীযান
Shrujal		শ্রুজল
Shubam		শুবম
Shuban		শুবন
Shubh		শুভ
Shubhaksh		শুভাক্ষ
Shubham		শুভম
Shubhang		শুভংগ
Shubhay		শুভায
Shuchet		শুচিত
Shuchit		শুচিত
Shuk		শুক
Shulabh		শুলভ
Shuli		শুলী
Shulin		শুলিন
Shushant		শুশাংত
Shvetang		শ্বেতাংগ
Shwet		শ্বেত
Shyam		শ্যাম
Shyamak		শ্যামক
Shyamal		শ্যামল
Siamak		স্যামক
Sian		সিযন
Siddhesh		সিদ্ধেশ
Siddhik		সিদ্ধিক
Simit		সীমিত
Sinhag		সিন্হাগ
Sinjan		সিংজন
Sinjeet		সিংজিত
Smaran		স্মরণ
Smayan		সমযান
Smeet		স্মিত
Smit		স্মিত
Smital		স্মীতল
Smitesh		স্মীতেশ
Sneh		স্নেহ
Snehal		স্নেহল
Snehan		স্নেহন
Snehil		স্নেহিল
Snehin		স্নেহীং
Snehit		স্নেহিত
Snehith		স্নেহিত
Sohail		সোহৈল
Soham		সোহম
Sohan		সোহন
Sohel		সোহেল
Sohil		সোহিল
Sohim		সোহীম
Sohum		সোহুম
Som		সোম
Somak		সোমক
Somali		সোমালী
Soman		সোমন
Somansh		সোমাংশ
Somik		সোমিক
Somil		সোমিল
Somit		সোমিত
Somvir		সোমবীর
Sonaksh		সোনাক্ষ
Soumil		সৌমীল
Soumili		সৌমিলী
Soumith		সৌমিত
Sourav		সৌরব
Souren		সৌরেন
Sourik		সৌরিক
Sourish		সৌরিশ
Souvik		সৌবিক
Sparsh		স্পর্শ
Sparsha		স্পর্শ
Sravan		শ্রবণ
Sree		শ্রী
Sreenesh		শ্রীনেশ
Sreepad		শ্রীপদ
Sriaansh		শ্রীআংশ
Srihan		শ্রীহন
Srikar		শ্রীকর
Srinav		শ্রীনব
Srinesh		শ্রীনেশ
Srini		শ্রীনী
Srinjay		শ্রৃংজয
Sriraj		শ্রী
Sritej		শ্রীতেজ
Srivas		শ্রী
Srivatsal		শ্রীবত্সল
Srivatsav		শ্রীবাত্সব
Sriyan		শ্রীযান
Sriyansh		শ্রীযাংশ
Srujal		সৃজল
Srujam		সৃজম
Srujan		সৃজন
Stutik		স্তুতিক
Subh		শুভ
Subhag		সুভগ
Subham		সুভম
Subhansh		সুভংশ
Subhash		সুভাষ
Suchit		সূচিত
Sudev		সুদেব
Sudhit		সুধিত
Sudin		সুদিন
Sudip		সুদীপ
Suhas		সুহাস
Suhit		সুহিত
Suhrid		সুহ্রিদ
Sujal		সুজল
Sukesh		সুকেশ
Sukhesh		সুখেশ
Sukrit		সুক্রিত
Sukul		সুকুল
Sumeer		সুমীর
Sumeet		সুমীত
Sumesh		সুমেশ
Sumiran		সুমিরন
Sumit		সুমীত
Sumuk		সুমুক
Sunand		সুনংদ
Sunav		সুনব
Sunay		সুনয
Sunchit		সুংচিত
Sundeep		সুংদীপ
Sundip		সুন্দীপ
Sunil		সুনীল
Sunny		সন্নী
Suryam		সূর্যম
Suryank		সুর্যাংক
Suryen		সুর্যেন
Suryesh		সুর্যেশ
Sutej		সুতেজ
Suvan		সুবন
Suvansh		সুবংশ
Suvir		সুবির
Suvit		সুবিত
Suyansh		সুযংশ
Suyash		সুযাশ
Suyati		সুযতী
Suyog		সুযোগ
Swant		সবংত
Swapn		স্বপ্ন
Swarup		স্বরূপ
Swastik		স্বস্তিক
Swayam		স্বযম
Sweekar		স্বীকার
Swet		শ্বেত
Swetal		স্বেতল
