Taha		তহা
Tahaan		তহান
Taksh		তক্ষ
Taksha		তক্ষা
Takshak		তক্ষক
Taksheel		তক্ষিল
Talin		তালিন
Tamas		তমস
Tamish		তমিশ
Tanav		তনাব
Tanay		তনয
Taneesh		তনিশ
Tanip		তনিপ
Tanish		তনিশ
Tanishk		তনিষ্ক
Tanishq		তনিশ্ক
Tanmai		তন্ময
Tanmay		তন্ময
Tanoj		তনোজ
Tanu		তনু
Tanuj		তনুজ
Tanul		তনুল
Tapan		তপন
Tapas		তপস
Tapesh		তপেশ
Tapish		তপীশ
Taraksh		তারাক্ষ
Tarang		তরংগ
Tarank		তারংক
Taraswin		তরস্বীন
Taresh		তারেশ
Tarik		তারিক
Tarit		তরিত
Taroosh		তারূশ
Tarpan		তর্পণ
Tarsh		তর্ষ
Tarun		তরুণ
Tarush		তারুষ
Tathvik		তাত্বিক
Tatva		তত্ব
Tatya		তাত্যা
Tautik		তৌতিক
Tavish		তবিশ
Tayak		তাযক
Teerth		তীর্থ
Tej		তেজ়
Tejai		তেজী
Tejal		তেজ়ল
Tejendra		তেজেন্দ্র
Tejul		তেজুল
Tejus		তেজুস
Tijil		তিজিল
Tikesh		তীকেশ
Tilak		তিলক
Timin		তিমিন
Timir		তিমির
Tirth		তীর্থ
Trijal		ত্রিজল
Trikay		ত্রিকায
Trilok		ত্রীলৌক
Trishal		ত্রিশল
Trishar		ত্রিষর
Trishiv		ত্রিশিব
Trishla		ত্রিশলা
Tushin		তুশীন
Tushir		তুষীর
Tushit		তুষিত
Tusya		তুস্য
