Ucchal		উচ্চল
Uchit		উচিত
Udant		উদংত
Udar		উদার
Udarsh		উদার্শ
Uday		উদয
Udayan		উদযন
Udbhav		উদ্ভব
Uddhav		উদ্ধব
Uddip		উদ্দীপ
Uddish		উদ্দীশ
Uddyam		উদ্যম
Udit		উদিত
Udupati		উদুপতী
Udyam		উদ্যম
Udyan		উদযন
Ugresh		উগ্রেশ
Ujagar		উজাগর
Ujala		উজালা
Ujas		উজাস
Ujay		উজয
Ujendra		উজেন্দ্র
Ujesh		উজেশ
Ujjal		উজ্জল
Ujjam		উজ্জম
Ujjan		উজ্জন
Ujjay		উজ্জয
Ujval		উজ্বল
Ujwal		উজ্বল
Ulagan		উলগন
Ulhas		উল্হাস
Umal		উমল
Umang		উমংগ
Umay		উময
Umed		উমেদ
Umesh		উমেশ
Unmesh		উন্মেশ
Unnabh		উন্নাভ
Unnat		উন্নত
Upamanyu		উপমন্যু
Upjeeth		উপজীত
Upol		উপোল
Uppas		উপ্পাস
Upvan		উপবন
Urav		উর্ব
Urdahav		উর্দাহাব
Urjani		উর্জানী
Urmil		উর্মিল
Urmit		উর্মিত
Urmiya		উর্মিযা
Urnik		উর্নীক
Urvang		উর্বংগ
Urvinath		উর্বীনাথ
Urvish		উর্বীশ
Urvisha		উর্বীশা
Ushnik		উশ্নীক
Utanka		উতংকা
Utkars		উত্কর্ষ
Utkarsh		উত্কর্ষ
Utkarsha		উত্কর্ষা
Utkarshraj		উত্কর্ষরাজ
Utpal		উত্পল
Utsav		উত্সব
Uttal		উত্তল
Uttam		উত্তম
Uttar		উত্তর
Uttiya		উত্তিযা
