Baha	Beautiful, Magnificent, Shining	3	Boy	
Basha	King	4	Boy	
Baadi	Distinct, Evident, Plain, Wonderful, Marvelous, Unique	8	Boy	
Baari	One of the names of God, Evolver a name of Allah, Free from the hell	22	Boy	
Bahu	Rod, A saints name	5	Boy	
Bahi	Glorious, Magnificent, Splendid, Brilliant, Shining	2	Boy	
Bari	One of the names of God, Evolver a name of Allah, Free from the hell	3	Boy	
Baar	Just, Pious	4	Boy	
Baqai	Immortal	3	Boy	
Baare	Brilliant, Superior	9	Boy	
Baal	Young, Infant, Strong, Strength, Vigour, Bridge, Victory	7	Boy	
Baqa	Survival, Immortality	3	Boy	
Baree	One of the names of God, Evolver a name of Allah, Free from the hell	22	Boy	
Baahi	Glorious, Magnificent, Splendid, Brilliant, Shining	3	Boy	
Badi	Distinct, Evident, Plain, Wonderful, Marvelous, Unique	7	Boy	
Baz	Falcon, Music, To play An instrument, Eagle	11	Boy	
Beg	Noble, Prince	5	Boy	
Baqi	Permanent, Everlasting	2	Boy	
Bazl	Prize, Reward	5	Boy	
Baahir	Dazzling, Brilliant	3	Boy	
Baasim	Smiling, Happy	9	Boy	
Bishr	Joy	11	Boy	
Basel	Brave	3	Boy	
Bilal	The prophets person calling prayer	9	Boy	
Bashar	Bringer of glad tidings, Human being	22	Boy	
Basaam	Smiling	1	Boy	
Bashir	Vision, Propitious, Auspicious, Prudent, Bringer of glad tidings	3	Boy	
Busr	Joy, Happiness, Unripe dates	6	Unisex	
Bahat	Beauty	5	Boy	
Badr	Full Moon	7	Unisex	
Bayan	Another name of holy Quran	7	Unisex	
Baheen	Exalted, Great, Noble	8	Boy	
Bihar	Temple, Monastery	11	Boy	
Baraz	Handsome	3	Boy	
Bakhsh	Gift, Fortunate, Give	22	Boy	
Babil	Babylon	8	Boy	
Babik	Law, A king name	7	Boy	
Bahij	Cheerful	3	Unisex	
Bazaan	The old emperor of Yaman, A companion of prophet (Pbuh)	9	Boy	
Baber	Courageous, Lion	1	Boy	
Basit	Vast, Spacious, One who stretches, Enlarges	6	Boy	
Baasir	Seeing, Wise, Bringer of good news	5	Boy	
Bareed	Messenger, Partner, Cloud	8	Boy	
Bazam	It was the name of the tabiee, Abu Salih	7	Boy	
Bahz	Name of bin Hakeem	1	Boy	
Baashir	Seeing, Wise, Bringer of good news	4	Boy	
Bariq	Shining, Lighting, Illuminating, Glitter, Flash, Luster, Bright	11	Boy	
Bazan	The old emperor of Yaman, A companion of prophet (Pbuh)	8	Boy	
Baariq	Shining, Lighting, Illuminating, Glitter, Flash, Luster, Bright	3	Boy	
Banseel	Brave	22	Boy	
Bahir	Dazzling, Brilliant	11	Boy	
Barhi	Thanks	11	Boy	
Basair	Another name of holy Quran, Good news, Good omens	5	Boy	
Balagh	Another name of holy Quran	22	Boy	
Baqar	Inevitable, Lion, Powerful	3	Boy	
Basiq	Clear	3	Boy	
Baseer	Vision, Propitious, Auspicious, Prudent, Bringer of glad tidings	5	Boy	
Basir	Vision, Propitious, Auspicious, Prudent, Bringer of glad tidings	22	Boy	
Burak	Horse like animal that carried the prophet (Pbuh) during Mehraj and will carry those that are selected on resurrection day	8	Boy	
Baleel	Moisture, One of the prophet	1	Boy	
Barni	Young, Grown up	8	Boy	
Baraj	Handsome	5	Boy	
Bakr	Old Arabic name	5	Boy	
Bakeet	Lover, Paramour	8	Boy	
Bakht	Luck, Fortune	6	Unisex	
Buraq	Horse like animal that carried the prophet (Pbuh) during Mehraj and will carry those that are selected on resurrection day	5	Boy	
Baseet	Vast, Spacious, One who stretches, Enlarges	7	Boy	
Batoor	Brave	8	Boy	
Bakhit	Lucky, Fortunate	6	Boy	
Balj	Delighted	7	Boy	
Bazir	Educated, A great person	11	Boy	
Basim	Smiling, Happy	8	Boy	
Bazish	Aggressive, Hardliner	11	Boy	
Bailul	Freshness	3	Boy	
Banaah	Tall and attractive	9	Boy	
Baraq	Electricity	3	Boy	
Bakir	Early	5	Boy	
Bareeq	Shining, Lighting, Illuminating, Glitter, Flash, Luster, Bright	3	Boy	
Baligh	Major, Eloquent, Learned, Vivid	3	Boy	
Basaud	Exalted, Blessed	3	Boy	
Beram	Fun, Eid, Enjoyment	3	Boy	
Budaira	Little full Moon	11	Boy	
Balay	Cornice, Eaves	5	Boy	
Basr	Eye-sight, Wisdom, Sight	4	Boy	
Badeeh	Wondrous	7	Boy	
Barr	Just, Pious	3	Boy	
Batal	Brave, Champion, Hero	9	Boy	
Bajala	Generous woman, Honored, Venerated	9	Boy	
Barir	Faithful	3	Boy	
Basan	One who uproots fully	1	Boy	
Baqir	Early	11	Boy	
Budair	Little full Moon	1	Boy	
Bandar	Seaport, District capital	22	Boy	
Basem	Smiling	4	Boy	
Behr	Wave	6	Boy	
Batin	Inward, Within, Secret	1	Boy	
Buland	Hight, Upward	9	Boy	
Bedar	Wakeful, Attentive, Alert, Awake	3	Boy	
Bujair	Name of sahabi ra who known	7	Boy	
Bakur	Precocious, Early coming	8	Boy
Barikaa	Bloom, Be successful, Persevering	7	Boy	
Bayt	Home	3	Boy	
Bakri	One who starts work early	5	Boy	
Bujud	Group of people	4	Boy	
Baseem	Smiling	9	Boy	
Borna	Young, Youthful	5	Boy	
Bushr	Joy, Happiness, Unripe dates	5	Boy	
Bazil	Merciful	5	Boy	
Basita	Generous	7	Boy	
Barzan	Visible	8	Boy	
Bahirun	Brilliant	1	Boy	
Barayek	Blessed	9	Boy	
Batlah	Independent	8	Boy	
Bajdan	Residnt	5	Boy	
Barkhan	Great leader	1	Boy	
Basmin	Joyful	22	Boy	
Bazullah	Gods warrior	11	Boy	
Barhamah	Young	7	Boy	
Barikah	Onw who strives	5	Boy	
Burhanah	Proof	1	Boy	
Biryar	Decision	1	Boy	
Barqah	Flash of light	11	Boy	
Bahili	Suggest meaning	5	Boy