Iesa	A prophets name	7	Boy	
Isa	A prophets name Jesus	11	Unisex	
Iraj	Lord Hanuman, Flower, Born of the primal waters, Another name for the Love God Kaama	2	Boy	
Izaan	Obedience	6	Boy	
Inas	Capable, Sociability, Powerful, Brilliant, Strong, Majestic, Another name for Surya	7	Unisex	
Ishir	Another name of Agni, Inspirational, Strong, Refreshing, Powerful, Fast, Agile	9	Boy	
Iham	Expected, Thin, Desire	22	Boy	
Isar	Selflessness, Eminent, Fascinating	2	Boy	
Iman	Faith, Belief, Faith in Allah	1	Boy	
Ishat	Superior, Eminence	3	Boy	
Isaam	Protector, Safeguard	7	Boy	
Imaad	Pillar, Post, Support	1	Boy	
Ibaad	A worshipper	8	Boy	
Izzi	Powerful	7	Unisex	
Isra	Related to God, Travel by night	2	Unisex	
Ilan	Good person	9	Boy	
Ishaq	Prophet name	9	Boy	
Iyad	Generous, A big mountain	3	Boy	
Iyaaz	Generous	8	Boy	
Imaan	Faith, Creed, Honesty, Belief, Truth honesty	2	Unisex	
Ilash	Another name of God	22	Boy	
Imam	Leader	9	Boy	
Izz	Prestige, High standing	7	Unisex	
Ijaz	Honor, Esteem, Regard	1	Unisex	
Iyas	Compensation, Consoling	9	Boy	
Izum	Obedient, Sincere	6	Boy	
Iyaad	Generous, A big mountain	22	Boy	
Ilahi	My Lord for (Allah), Divine	3	Boy	
Isad	Making Happy, Prosperous	6	Unisex	
Iyaas	Compensation, Consoling	1	Boy	
Imad	Pillar, Post, Support	9	Boy	
Inab	Grape	8	Boy	
Ihab	Leather	2	Unisex	
Ijli	This was the name of the makes of astrolabes	22	Boy	
Izaz	Honor, Esteem, Regard	8	Unisex	
Izat	Respect	2	Boy	
Injeel	The gopels	1	Boy	
Iim	Science	22	Boy	
Isam	Protector, Safeguard	6	Boy	
Itakh	The name of abu Mansur, The	22	Boy	
Inam	Act of kindness, Benefaction, Bestowal, Gift, Present, Prize, Grant	1	Unisex	
Iraq	River bank	9	Boy	
Isaar	Selflessness, Eminent, Fascinating	3	Boy	
Intiha	Conclusion	7	Boy	
Iyali	Name of abu Jafar, A jurist	11	Boy	
Idris	A prophets name, Fiery Lord	5	Boy	
Iqyan	Gold	3	Boy	
Inhal	To pour	8	Boy	
Inbihaj	Delight	8	Boy	
Irmas	Strong	6	Boy	
Insijam	Harmony	3	Boy	
Injah	Success	6	Boy	
Inshiraf	Honor	3	Boy	
Inabah	Vine	8	Boy	
Inbisat	Comfort	11	Boy